0 0 0 0 0 0 0 0 0 0 0 0 0 0 0 0 0 0 0 0 0 0 0 0 0 0 0 0 0 0 0 0 0 0 0 0 0 0 0 0 0 0 0 0 0 0 0 0 0 0 
0 0 0 0 0 0 0 0 0 0 0 0 0 0 0 0 0 0 0 0 0 0 0 0 0 0 0 0 0 0 0 0 0 0 0 0 0 0 0 0 0 0 0 0 0 0 0 0 0 0 
0 0 0 0 0 0 0 0 0 0 0 0 0 0 0 0 0 0 0 0 0 0 0 0 0 0 0 0 0 0 0 0 0 0 0 0 0 0 0 0 0 0 0 0 0 0 0 0 0 0 
0 0 0 0 0 0 0 0 0 0 0 0 0 0 0 0 0 0 0 0 0 0 0 0 0 0 0 0 0 0 0 0 0 0 0 0 0 0 0 0 0 0 0 0 0 0 0 0 0 0 
0 0 0 0 0 0 0 0 0 0 0 0 0 0 0 0 0 0 0 0 0 0 0 0 0 0 0 0 0 0 0 0 0 0 0 0 0 0 0 0 0 0 0 0 0 0 0 0 0 0 
0 0 0 0 0 0 0 0 0 0 0 0 0 0 0 0 0 0 0 0 0 0 0 0 0 0 0 0 0 0 0 0 0 0 0 0 0 0 0 0 0 0 0 0 0 0 0 0 0 0 
0 0 0 0 0 0 0 79 78 78 79 79 79 79 79 79 79 79 79 79 79 79 79 79 79 79 79 79 79 79 79 79 79 79 79 79 79 79 79 79 79 79 79 0 0 0 0 0 0 0 
0 0 0 0 0 0 0 79 66 29 79 79 79 79 79 78 78 78 78 78 78 79 79 79 79 79 79 79 79 79 79 78 78 78 78 78 78 79 79 79 79 79 79 0 0 0 0 0 0 0 
0 0 0 0 0 0 0 79 29 29 79 79 79 79 78 29 29 29 29 29 29 78 79 79 79 79 79 79 79 79 78 29 29 29 29 29 29 79 79 79 79 79 79 0 0 0 0 0 0 0 
0 0 0 0 0 0 0 79 79 29 78 78 78 78 29 29 29 29 29 29 29 29 79 79 79 79 78 78 78 78 29 29 29 29 79 79 29 78 79 79 79 79 79 0 0 0 0 0 0 0 
0 0 0 0 0 0 0 79 79 29 29 29 29 29 29 29 29 29 29 29 29 29 79 79 79 78 29 29 29 29 29 29 29 79 79 79 29 29 79 79 79 79 79 0 0 0 0 0 0 0 
0 0 0 0 0 0 0 79 79 79 79 79 79 79 29 29 29 29 29 29 29 29 79 79 78 29 29 29 29 29 29 29 79 79 79 79 79 29 78 79 79 79 79 0 0 0 0 0 0 0 
0 0 0 0 0 0 0 79 79 79 79 79 79 79 79 29 29 29 29 29 29 79 79 78 29 29 29 29 29 29 79 79 79 79 79 79 78 29 29 78 79 79 79 0 0 0 0 0 0 0 
0 0 0 0 0 0 0 79 79 79 79 79 79 79 79 79 79 79 29 79 79 79 78 29 29 29 29 79 79 79 79 79 79 79 79 78 29 29 29 29 79 79 79 0 0 0 0 0 0 0 
0 0 0 0 0 0 0 79 79 79 79 79 79 79 79 78 78 78 29 78 79 79 29 29 29 79 79 78 79 79 79 79 79 79 79 29 29 29 29 29 78 79 79 0 0 0 0 0 0 0 
0 0 0 0 0 0 0 79 79 79 79 79 79 78 78 29 29 29 29 29 79 79 29 29 29 79 79 29 79 79 79 79 79 79 78 29 29 29 29 29 29 79 79 0 0 0 0 0 0 0 
0 0 0 0 0 0 0 79 78 78 79 79 79 29 29 29 79 29 29 29 79 79 29 79 79 78 78 29 78 78 79 79 78 78 29 29 29 29 29 29 29 79 79 0 0 0 0 0 0 0 
0 0 0 0 0 0 0 79 29 29 78 78 78 79 79 79 79 79 29 79 79 79 29 79 79 29 29 29 29 29 79 78 29 29 29 79 79 29 29 29 79 79 79 0 0 0 0 0 0 0 
0 0 0 0 0 0 0 79 29 29 29 29 29 79 79 79 79 79 29 79 79 79 29 79 79 29 29 29 29 29 78 29 29 79 79 79 79 79 29 79 79 79 79 0 0 0 0 0 0 0 
0 0 0 0 0 0 0 79 29 29 29 29 29 79 79 79 79 79 29 79 79 79 29 79 79 29 29 29 29 29 29 29 79 79 79 79 79 79 29 79 79 79 79 0 0 0 0 0 0 0 
0 0 0 0 0 0 0 79 29 29 29 29 29 79 79 79 79 79 29 79 79 79 29 78 79 79 29 29 29 29 79 79 79 79 79 79 79 79 29 79 79 79 79 0 0 0 0 0 0 0 
0 0 0 0 0 0 0 79 29 29 29 29 29 79 79 79 79 79 29 79 78 78 29 29 79 79 79 79 79 79 79 79 79 79 79 79 79 79 29 79 79 79 79 0 0 0 0 0 0 0 
0 0 0 0 0 0 0 79 79 79 29 79 79 79 79 79 79 79 29 79 29 29 29 29 79 79 79 79 79 79 79 79 79 79 79 79 79 78 29 78 78 79 79 0 0 0 0 0 0 0 
0 0 0 0 0 0 0 79 79 79 29 79 79 79 78 78 78 78 29 78 78 78 79 79 79 79 79 79 79 79 79 79 79 79 78 78 78 29 29 29 29 79 79 0 0 0 0 0 0 0 
0 0 0 0 0 0 0 79 79 79 29 79 79 78 29 29 29 29 29 29 29 29 78 79 79 79 79 79 79 79 79 79 78 78 29 29 29 29 29 29 29 79 79 0 0 0 0 0 0 0 
0 0 0 0 0 0 0 79 79 79 29 78 78 29 29 29 29 29 29 29 29 29 29 79 79 79 79 79 79 79 79 79 29 29 29 29 29 29 29 29 29 79 79 0 0 0 0 0 0 0 
0 0 0 0 0 0 0 79 79 79 29 29 29 29 29 29 29 29 29 29 29 29 29 79 79 79 79 79 79 79 79 79 29 29 29 29 29 29 29 29 29 79 79 0 0 0 0 0 0 0 
0 0 0 0 0 0 0 79 79 79 29 29 29 29 29 29 29 29 29 29 29 29 29 78 78 78 78 78 78 78 78 78 29 29 29 29 29 29 29 29 29 79 79 0 0 0 0 0 0 0 
0 0 0 0 0 0 0 79 79 79 79 79 79 79 29 29 29 29 29 29 29 29 29 29 29 29 29 29 29 29 29 29 29 29 29 29 29 79 79 29 29 79 79 0 0 0 0 0 0 0 
0 0 0 0 0 0 0 79 79 79 79 79 79 79 79 79 79 29 29 79 79 79 79 79 79 79 29 79 79 79 79 79 29 29 29 79 79 79 78 29 29 79 79 0 0 0 0 0 0 0 
0 0 0 0 0 0 0 79 79 79 79 79 79 79 79 79 79 29 29 79 79 79 79 79 79 79 29 79 79 79 79 79 79 79 79 79 79 79 29 29 29 79 79 0 0 0 0 0 0 0 
0 0 0 0 0 0 0 79 79 79 79 79 79 79 79 79 79 29 29 79 79 79 79 79 79 79 29 79 79 79 79 79 79 79 79 79 79 79 79 29 29 79 79 0 0 0 0 0 0 0 
0 0 0 0 0 0 0 79 79 79 79 79 79 79 79 79 79 29 29 79 79 79 79 79 79 78 29 78 79 79 79 79 79 79 79 79 79 79 79 79 79 79 79 0 0 0 0 0 0 0 
0 0 0 0 0 0 0 79 79 79 79 79 79 79 79 79 79 29 29 79 79 79 79 79 79 29 29 29 79 79 79 79 79 79 79 79 79 79 79 79 79 79 79 0 0 0 0 0 0 0 
0 0 0 0 0 0 0 79 79 79 79 79 79 79 79 78 78 29 29 78 78 79 79 79 79 29 29 29 79 79 79 79 79 79 79 79 79 79 79 79 79 79 79 0 0 0 0 0 0 0 
0 0 0 0 0 0 0 79 79 79 79 79 79 79 79 29 29 29 29 29 29 79 79 79 79 79 79 79 79 79 79 79 79 79 79 79 79 79 79 79 79 79 79 0 0 0 0 0 0 0 
0 0 0 0 0 0 0 79 79 78 78 78 78 78 78 29 29 29 29 29 29 79 79 79 79 79 79 79 79 79 79 79 79 79 79 79 78 78 78 78 78 79 79 0 0 0 0 0 0 0 
0 0 0 0 0 0 0 79 79 29 29 29 29 29 29 29 29 29 29 29 29 79 79 79 79 79 79 79 79 79 79 79 78 78 78 78 29 29 29 29 29 79 79 0 0 0 0 0 0 0 
0 0 0 0 0 0 0 79 79 29 79 79 79 79 79 29 29 29 29 29 29 79 79 79 79 79 79 79 79 79 79 78 29 29 29 29 29 29 79 79 29 79 79 0 0 0 0 0 0 0 
0 0 0 0 0 0 0 79 78 29 78 79 79 79 79 29 29 29 29 29 29 78 78 78 78 78 78 78 78 78 78 29 29 29 29 29 29 79 79 79 29 79 79 0 0 0 0 0 0 0 
0 0 0 0 0 0 0 79 29 29 29 79 79 79 79 29 29 29 29 29 29 29 29 29 29 29 29 29 29 29 29 29 29 29 29 29 29 79 79 79 29 79 79 0 0 0 0 0 0 0 
0 0 0 0 0 0 0 79 29 67 29 79 79 79 79 79 79 79 79 79 79 79 79 79 79 79 79 79 79 79 79 79 29 29 29 29 29 79 79 79 29 79 79 0 0 0 0 0 0 0 
0 0 0 0 0 0 0 79 29 29 29 79 79 79 79 79 79 79 79 79 79 79 79 79 79 79 79 79 79 79 79 79 79 79 79 79 79 79 79 79 79 79 79 0 0 0 0 0 0 0 
0 0 0 0 0 0 0 78 78 78 78 78 78 78 78 78 78 78 78 78 78 78 78 78 78 78 78 78 78 78 78 78 78 78 78 78 78 78 78 78 78 78 78 0 0 0 0 0 0 0 
0 0 0 0 0 0 0 0 0 0 0 0 0 0 0 0 0 0 0 0 0 0 0 0 0 0 0 0 0 0 0 0 0 0 0 0 0 0 0 0 0 0 0 0 0 0 0 0 0 0 
0 0 0 0 0 0 0 0 0 0 0 0 0 0 0 0 0 0 0 0 0 0 0 0 0 0 0 0 0 0 0 0 0 0 0 0 0 0 0 0 0 0 0 0 0 0 0 0 0 0 
0 0 0 0 0 0 0 0 0 0 0 0 0 0 0 0 0 0 0 0 0 0 0 0 0 0 0 0 0 0 0 0 0 0 0 0 0 0 0 0 0 0 0 0 0 0 0 0 0 0 
0 0 0 0 0 0 0 0 0 0 0 0 0 0 0 0 0 0 0 0 0 0 0 0 0 0 0 0 0 0 0 0 0 0 0 0 0 0 0 0 0 0 0 0 0 0 0 0 0 0 
0 0 0 0 0 0 0 0 0 0 0 0 0 0 0 0 0 0 0 0 0 0 0 0 0 0 0 0 0 0 0 0 0 0 0 0 0 0 0 0 0 0 0 0 0 0 0 0 0 0 
0 0 0 0 0 0 0 0 0 0 0 0 0 0 0 0 0 0 0 0 0 0 0 0 0 0 0 0 0 0 0 0 0 0 0 0 0 0 0 0 0 0 0 0 0 0 0 0 0 0 
