26 26 26 26 26 26 26 26 26 26 26 26 26 26 26 26 26 26 26 26 26 26 26 26 26 26 26 26 26 26 26 26 26 26 26 26 26 26 26 26 26 26 26 26 26 26 26 26 26 26 
26 26 26 26 26 26 26 26 26 26 26 26 26 26 26 26 26 26 26 26 26 26 26 26 26 26 26 26 26 26 26 26 26 26 26 26 26 26 26 26 26 26 26 26 26 26 26 26 26 26 
26 26 26 26 26 26 26 26 26 26 26 26 26 26 26 26 26 26 26 26 26 26 26 26 26 26 26 26 26 26 26 26 26 26 26 26 26 26 26 26 26 26 26 26 26 26 26 26 26 26 
26 26 26 26 26 26 26 26 26 26 26 26 26 26 26 26 26 26 26 26 26 26 26 26 26 26 26 26 26 26 26 26 26 26 26 26 26 26 26 26 26 26 26 26 26 26 26 26 26 26 
26 26 26 26 26 26 26 26 26 26 26 26 26 26 26 26 26 26 26 26 26 26 26 26 26 26 26 26 26 26 26 26 26 26 26 26 26 26 26 26 26 26 26 26 26 26 26 26 26 26 
26 26 26 26 26 26 26 26 26 26 26 26 26 26 26 26 26 26 26 26 26 26 26 26 26 26 26 26 26 26 26 26 26 26 26 26 26 26 26 26 26 26 26 26 26 26 26 26 26 26 
26 26 26 26 26 26 26 26 12 46 46 46 46 46 46 46 13 26 12 46 46 46 46 46 46 46 46 13 26 26 26 12 46 46 46 46 46 46 46 46 46 46 13 26 26 26 26 26 26 26 
26 26 26 26 26 26 26 26 27 20 79 78 78 78 79 20 45 46 47 20 69 69 69 69 69 69 69 45 46 46 46 47 20 69 16 57 57 57 57 57 57 18 25 26 26 26 26 26 26 26 
26 26 26 26 26 26 26 26 27 20 79 29 29 29 79 20 20 20 20 20 69 1 3 3 3 4 69 20 20 20 20 20 20 20 39 70 70 70 70 70 70 17 25 26 26 26 26 26 26 26 
26 26 26 26 26 26 26 26 27 20 79 29 66 29 79 20 20 20 20 20 69 41 68 68 68 44 69 20 20 20 20 20 20 20 39 70 70 70 70 70 70 17 25 26 26 26 26 26 26 26 
26 26 26 26 26 26 26 26 27 20 79 29 29 29 79 20 20 20 20 20 69 41 68 68 68 44 69 20 20 20 20 20 20 20 39 70 70 70 70 70 70 17 25 26 26 26 26 26 26 26 
26 26 26 26 26 26 26 26 27 20 79 29 29 29 79 20 20 20 20 20 69 61 63 63 63 64 69 20 20 20 20 20 20 20 39 70 70 70 70 70 70 17 25 26 26 26 26 26 26 26 
26 26 26 26 26 26 26 26 27 20 78 78 69 78 78 20 20 20 20 20 69 69 16 57 18 69 69 69 69 69 69 69 69 69 59 37 37 38 70 36 37 19 25 26 26 26 26 26 26 26 
26 26 26 26 26 26 26 26 27 20 20 20 69 20 20 20 20 20 20 20 20 20 39 70 17 20 20 20 20 20 20 20 20 20 20 20 20 39 70 17 5 6 73 26 26 26 26 26 26 26 
26 26 26 26 26 26 26 26 72 7 20 20 69 20 20 20 20 20 20 20 20 20 39 70 17 20 20 20 20 20 20 20 20 20 20 20 20 39 70 17 25 26 26 26 26 26 26 26 26 26 
26 26 26 26 26 26 26 26 26 27 20 20 69 20 20 20 20 20 20 20 20 20 39 70 17 20 20 20 20 20 20 20 20 20 20 20 20 39 70 17 25 26 26 26 26 26 26 26 26 26 
26 26 26 26 26 26 26 26 12 47 20 20 69 20 20 20 20 20 20 20 20 20 39 70 17 69 69 69 20 20 20 20 20 20 20 20 20 39 70 17 25 26 26 26 26 26 26 26 26 26 
26 26 26 26 26 26 26 12 47 20 20 20 69 20 20 20 20 20 20 20 20 20 39 70 17 20 20 20 20 20 20 20 20 20 20 16 57 58 70 17 25 26 26 26 26 26 26 26 26 26 
26 26 26 26 26 26 26 27 20 20 69 69 69 20 20 20 20 20 20 20 20 20 39 70 17 20 20 20 20 20 20 20 20 20 20 39 70 70 70 17 25 26 26 26 26 26 26 26 26 26 
26 26 26 26 26 26 26 27 20 20 69 20 20 20 20 20 20 20 20 20 20 69 39 70 17 69 20 20 20 20 20 20 20 20 20 39 70 36 37 19 25 26 26 26 26 26 26 26 26 26 
26 26 26 26 26 26 26 27 20 20 69 20 20 69 16 57 57 57 57 57 57 57 58 70 56 57 57 57 57 18 20 20 20 16 57 58 70 17 69 69 25 26 26 26 26 26 26 26 26 26 
26 26 26 26 26 26 26 27 20 20 69 20 20 69 39 70 70 70 70 70 70 70 70 70 70 70 70 70 70 17 69 69 69 39 70 70 70 17 69 20 25 26 26 26 26 26 26 26 26 26 
26 26 26 26 26 26 26 27 20 20 69 20 20 69 59 37 37 37 37 37 37 37 38 70 36 37 37 37 37 19 20 20 20 59 37 38 70 17 69 5 73 26 26 26 26 26 26 26 26 26 
26 26 26 26 26 26 26 72 7 20 69 20 20 69 20 20 20 20 20 20 20 69 39 70 17 69 20 20 20 20 20 20 20 20 20 39 70 17 69 25 26 26 26 26 26 26 26 26 26 26 
26 26 26 26 26 26 26 26 27 20 69 20 20 69 20 20 20 20 20 20 20 20 39 70 17 20 20 20 20 20 20 20 20 20 20 39 70 17 69 25 26 26 26 26 26 26 26 26 26 26 
26 26 26 26 26 26 26 12 47 20 69 20 20 69 69 20 20 20 20 20 20 20 39 70 17 20 20 20 20 20 20 20 20 20 20 39 70 17 69 25 26 26 26 26 26 26 26 26 26 26 
26 26 26 26 26 26 26 27 20 20 69 20 20 20 69 20 20 20 20 20 20 20 39 70 17 20 20 20 20 20 20 20 20 20 20 39 70 17 69 25 26 26 26 26 26 26 26 26 26 26 
26 26 26 26 26 26 26 27 20 20 69 20 20 20 69 20 20 20 20 20 20 20 39 70 17 69 69 69 20 20 20 20 20 20 20 39 70 17 69 25 26 26 26 26 26 26 26 26 26 26 
26 26 26 26 26 26 26 27 20 20 69 20 20 20 69 20 20 20 20 20 20 20 39 70 17 20 20 69 20 20 20 20 20 20 20 39 70 17 69 25 26 26 26 26 26 26 26 26 26 26 
26 26 26 26 26 26 26 27 20 20 69 69 69 69 69 69 20 20 20 20 20 20 39 70 17 20 20 69 20 20 69 20 20 20 20 59 37 19 69 25 26 26 26 26 26 26 26 26 26 26 
26 26 26 26 26 26 26 27 20 20 69 69 69 69 69 69 20 20 20 20 20 20 39 70 17 20 20 69 20 20 69 20 20 20 20 20 69 20 5 73 26 26 26 26 26 26 26 26 26 26 
26 26 26 26 26 26 26 72 7 20 69 69 69 69 69 69 20 20 20 20 20 20 39 70 17 20 20 69 69 69 69 20 20 20 20 20 69 69 25 26 26 26 26 26 26 26 26 26 26 26 
26 26 26 26 26 26 26 26 27 20 69 69 69 69 69 69 20 20 20 20 20 20 39 70 17 20 20 20 20 20 20 20 20 20 20 69 69 69 25 26 26 26 26 26 26 26 26 26 26 26 
26 26 26 26 26 26 26 26 27 20 69 69 69 69 69 69 20 20 20 20 20 20 39 70 17 20 20 20 20 20 20 20 20 20 20 69 69 69 25 26 26 26 26 26 26 26 26 26 26 26 
26 26 26 26 26 26 26 26 27 20 69 69 69 69 69 69 20 20 20 20 20 20 39 70 17 20 20 20 20 20 20 20 20 20 20 69 69 69 25 26 26 26 26 26 26 26 26 26 26 26 
26 26 26 26 26 26 26 12 47 20 20 20 20 20 20 20 20 20 20 20 20 20 59 37 19 20 20 20 20 20 20 20 20 20 20 69 69 69 45 13 26 26 26 26 26 26 26 26 26 26 
26 26 26 26 26 26 26 27 20 20 20 20 20 20 20 20 20 20 20 20 69 69 69 69 69 69 69 20 20 20 20 20 20 20 69 69 69 69 69 45 13 26 26 26 26 26 26 26 26 26 
26 26 26 26 26 26 26 27 20 20 20 20 20 20 20 20 20 20 20 69 69 69 69 69 69 69 69 69 20 20 69 20 20 69 69 69 69 69 69 69 25 26 26 26 26 26 26 26 26 26 
26 26 26 26 26 26 26 27 20 20 20 20 20 20 20 20 20 20 20 69 69 69 69 69 69 69 69 69 20 20 20 20 69 69 69 69 69 69 69 69 25 26 26 26 26 26 26 26 26 26 
26 26 26 26 26 26 26 27 20 20 40 20 20 20 20 20 20 20 20 69 69 69 69 69 69 69 69 69 69 20 20 20 69 69 69 69 69 20 69 69 25 26 26 26 26 26 26 26 26 26 
26 26 26 26 26 26 26 27 20 20 69 20 20 69 69 69 69 69 69 69 69 69 69 69 69 69 69 69 69 69 69 69 69 69 20 69 69 69 69 69 25 26 26 26 26 26 26 26 26 26 
26 26 26 26 26 26 26 27 20 20 69 69 69 69 20 5 6 6 7 69 69 69 69 69 69 69 69 5 6 6 7 69 69 69 69 69 69 69 69 69 25 12 13 26 26 26 26 26 26 26 
26 26 26 26 26 26 26 27 20 20 20 20 20 20 5 73 26 26 72 7 69 69 69 69 69 69 5 73 26 26 27 69 69 20 69 69 20 69 69 69 25 32 33 26 26 26 26 26 26 26 
26 26 26 26 26 26 26 72 6 6 6 6 6 6 73 26 26 26 26 72 6 6 6 6 6 6 73 26 26 26 72 7 69 69 69 69 69 69 5 6 73 52 53 26 26 26 26 26 26 26 
26 26 26 26 26 26 26 26 26 26 26 26 26 26 26 26 26 26 26 26 26 26 26 26 26 26 26 26 26 26 26 72 6 6 6 6 6 6 73 26 26 54 55 26 26 26 26 26 26 26 
26 26 26 26 26 26 26 26 26 26 26 26 26 26 26 26 26 26 26 26 26 26 26 26 26 26 26 26 26 26 26 26 26 26 26 26 26 26 26 26 26 52 53 26 26 26 26 26 26 26 
26 26 26 26 26 26 26 26 26 26 26 26 26 26 26 26 26 26 26 26 26 26 26 26 26 26 26 26 26 26 26 26 26 26 26 26 26 26 26 26 26 26 26 26 26 26 26 26 26 26 
26 26 26 26 26 26 26 26 26 26 26 26 26 26 26 26 26 26 26 26 26 26 26 26 26 26 26 26 26 26 26 26 26 26 26 26 26 26 26 26 26 26 26 26 26 26 26 26 26 26 
26 26 26 26 26 26 26 26 26 26 26 26 26 26 26 26 26 26 26 26 26 26 26 26 26 26 26 26 26 26 26 26 26 26 26 26 26 26 26 26 26 26 26 26 26 26 26 26 26 26 
26 26 26 26 26 26 26 26 26 26 26 26 26 26 26 26 26 26 26 26 26 26 26 26 26 26 26 26 26 26 26 26 26 26 26 26 26 26 26 26 26 26 26 26 26 26 26 26 26 26 
